{
  "`": "×",
  "1": "1",
  "2": "2",
  "3": "3",
  "4": "4",
  "5": "5",
  "6": "6",
  "7": "7",
  "8": "8",
  "9": "9",
  "0": "0",
  "-": "-",
  "=": "=",
  "q": "ض",
  "w": "ص",
  "e": "ث",
  "r": "ق",
  "t": "ف",
  "y": "غ",
  "u": "ع",
  "i": "ه",
  "o": "خ",
  "p": "ح",
  "[": "ج",
  "]": "چ",
  "a": "ش",
  "s": "س",
  "d": "ی",
  "f": "ب",
  "g": "ل",
  "h": "ا",
  "j": "ت",
  "k": "ن",
  "l": "م",
  ";": "ک",
  "'": "گ",
  "\\": "پ",
  "z": "ظ",
  "x": "ط",
  "c": "ز",
  "v": "ر",
  "b": "ذ",
  "n": "د",
  "m": "ئ",
  ",": "و",
  ".": ".",
  "/": "/",
  "~": "×",
  "!": "!",
  "@": "@",
  "#": "#",
  "$": "$",
  "%": "%",
  "^": "^",
  "&": "&",
  "*": "*",
  "(": ")",
  ")": "(",
  "_": "_",
  "+": "+",
  "Q": "ً",
  "W": "ٌ",
  "E": "ٍ",
  "R": "ريال",
  "T": "،",
  "Y": "؛",
  "U": ",",
  "I": "]",
  "O": "[",
  "P": "\\",
  "{": "}",
  "}": "{",
  "A": "َ",
  "S": "ُ",
  "D": "ِ",
  "F": "ّ",
  "G": "ۀ",
  "H": "آ",
  "J": "ـ",
  "K": "«",
  "L": "»",
  ":": ":",
  "\"": "\"",
  "|": "|",
  "Z": "ة",
  "X": "ي",
  "C": "ژ",
  "V": "ؤ",
  "B": "إ",
  "N": "أ",
  "M": "ء",
  "<": "<",
  ">": ">",
  "?": "؟"
}